111111111111111111111111
10000000000000000000000111111
10000000000000500000000000001
10000000000000000000000000001
10000000000000000000000100011
100000222220000303030001000011111111
1000002000200000000000010101010101011
10000020002000030003000101010000000011
1000002000200000000000010100011101010111111111111111111111111011
100000220220000303030001010000000000000111111111111111111111111011
1000000000000000000000011111110111110101111111111111111111111051
1000000000000000000000011111000111110000000000000000000000000001
1000000000000000000000010001110011111111111111111111111111111111
100000000000000000000001111111001
100000000100000000000001111110011
10000000000000000000000111111001
1000000000000000000000011111001
14444444400000000000000111111001
1404000040000000000000011111001
1400005040000000000000011111001
1404000040000000000000011111001
1404444440000000000000011111001
140000000000000000000001111001
1444444440000000000000011111001
1111111111111111111111111110111
