111111111111111111111111
  10df00000000000000000001
  100gs00000000000000000001
  100000a00000ag0000000000001
  100000222220000303030001
  10    0000200020000000000001
  100000200020000300030001
  10000 0 200020000000000001
  10000 0220220000303030001
  10000s s- 0000000000000000001
  10000000000120000000000001
  1000000000000 200000000001
  100000000000000000000001
  100000000100000005000001
  100000000000000000000001
  100000000000000000000001
  14444444400000 1';as0000000001
  140400004000000000000001
  14000050400000000sf0000001
  140400004000000000000001
  140444444000000000adfss000001
  140000000000000000000sdf001
  144444444000000000000001
  111111111111111111111111
